%%%%%%%%
%.    .%
%   P  %
%      %
%      %
%      %
%.    .%
%%%%%%%%
